
XXXXXXXXXXXXXXXXXXXXXXXXXXXXXXXXXXXXXXXXXXXXXXXXXXXXXXXXXXXXXXXXXXXXXXXXX        
XP C E                                                                  X        
XXXXXXX                                                                 X        
      X                                                                 X        
      X    S S S S S S S                                                X        
      XXXXXXXXXXXXXXX                                                     X        
                    X                                                     X        
                    X               M                 M                 X        
                    X      XXXXXXXXXXXXXXXXXXXXXXXXXXXXXXXXXXXXXX       X        
                    X      X                                    X       X        
                    X      X        C                           X       X        
      XXXXXXXXXXXXXXXX      X   XXXXXXXXXXXXXXXXXXXXXXX           X       X        
      X                     X   X                     X           X       X        
      X     S S S S S       X   X    S S S S S S      X           X       X        
      XXXXXXXXXXXXXXXXXXX   X   XXXXXXXXXXXXXXXXXXX   X           X       X        
                          X   X                     X   X         X       X        
     M                    X   X          M          X   X         X       X        
XXXXXXXXXXXXXXXXXXXXXXXXXXXXXXX                     XXXXXXXXXXXXXXXXXXXXXXX        
