                                                                                 
                                                                                 
P                                                                                
XXXXX       C                                                                    
X   X      XXX                                                                   
X   X     X S X                                                                  
XXXXX    XXXXXXX                                                                 
         X     X         XXXX                                                    
         X     X        X    X                                                   
         XXXXXXX       X S  S X        C                                         
                      XXXXXXXXXX     XXXXX        SSSXSSS                        
                                    X     X      X       X                       
 XXX        B                      X S S S X    XX S S S XX                      
X S X                             XXXXXXXXX   XXX       XXX                      
XXXXX                    B                     XXXXX   XXXXX                     
                    H                           X     X     X                    
        XXXXXXXXXXXXXXXXXXXXXXXXXXXXX              M    S XXXX                   
       X                             X        XXXXXXXXXXXXXXXXXXXXXX             
      X S S S S S S S S S S S S S S S X      X                  XX   E             
XXXXXXXXXXXXXXXXXXXXXXXXXXXXXXXXXXXXXXXXXXXXXXXXXXXXXXXXXXXXXXXXXXXXXXXXXXX      